10
####################
#s#       #f   #   #
# ####### #### # # #
#         #  # ### #
##### ### #        #
#   # #   ####### ##
#   # # ### #   #  #
#   # # #   # # ## #
#     #   #   #    #
####################